222222222222222222222222222222
211111111111111111111111111112
211133333111111111111133311112
211333311111111111111113331112
211113331111111111111113311112
211111111111111111111331111112
211111131331111111113331111112
211111313333111111111311111112
211111133133111111111111111112
211111133331111111111111111112
211111111131111111113331111112
211111113311311111111111111112
211111111333111111111111111112
211111111111311111113331111112
211111111113111111113131111112
211111111111111111111311111112
211111111111111111113111111112
211111111111111111111111111112
211111113111111111111111111112
211111331111111111111331111112
211111333311111111133311111112
211113333111111111333331111112
211111113311311111111111111112
211111111333111111111111111112
211111111111311111113331111112
211111111113111111113131111112
211111111111111111111311111112
211111111111111111113111111112
211111111111111111111111111112
211111113111111111111111111112
211111331111111111111331111112
211111333311111111133311111112
211113333111111111333331111112
211133333111111111331131111112
211111333331111111111111111112
211111131131111111111111111112
211111111111111111111131131112
211111111111111111111131331112
211111111111111111111113311112
211111111111111111111111111112
222222222222222222222222222222
