222222222222222222222222222222
211111111111111111111111111112
211111111111111111111111111112
211111111111111111111111111112
211111111111111111111111111112
211111111111111111111111111112
211111111111111111111111111112
211111111111111111111111111112
211111111111111111114441111112
211111111111111111114441111112
211111111111111111114441111112
211111111111111111114441111112
211111111111111111114441111112
211111111111111111114441111112
211111111111111111111111111112
211111111111111111111111111112
211111111111111111111111111112
211111111111111111111111111112
211111111111111111111111111112
211111111111111111111111111112
211111333111111111111111111112
211111333111111111111111111112
211111333111111111111111111112
211111333111111111111111111112
211111111111111111111111111112
211111111111111111111111111112
211111111111111111111111111112
211111111111111111111111111112
211111111111111111111111111112
222222222222222222222222222222
